{
    "id": 2,
    "tile_data": [
        [0, 0, 0],
        [1, 0, 0],
        [2, 0, 0],
        [3, 0, 0],
        [4, 0, 0],
        [5, 0, 0],
        [6, 0, 0],
        [7, 0, 0],
        [0, 1, 0],
        [0, 2, 0],
        [0, 3, 0],
        [7, 1, 0],
        [7, 2, 0],
        [7, 3, 0],
        [1, 3, 0],
        [2, 3, 0],
        [3, 3, 0],
        [4, 3, 0],
        [5, 3, 0],
        [6, 3, 0],
        [7, 3, 0],
        [1, 1, 1],
        [2, 1, 1],
        [3, 1, 1],
        [4, 1, 1],
        [5, 1, 1],
        [6, 1, 1],
        [1, 2, 1],
        [2, 2, 1],
        [3, 2, 1],
        [4, 2, 1],
        [5, 2, 1],
        [6, 2, 1],
        [2, 1, 4],
        [4, 1, 0],
        [5, 1, 4],
        [6, 1, 0],
        [6, 2, 3]
    ],
    "player_start": [1, 1],
    "max_moves": 6,
    "max_jumps": 0,
    "switches": [
        {
            "pos": [2, 1],
            "targets": [[4, 1], [6, 1]],
            "types": [0, 1]
        },
        {
            "pos": [5, 1],
            "targets": [[3, 1]],
            "types": [0, 1]
        }
    ]
}